111111111111
100TE00000B1
101S100T0001
100000000001
10T00T000T01
1000TB000001
10000T000001
100T00000T01
10000EEE0001
100T000T0001
100000000001
111111111111